

NO ./resources/textures/blue.xpm
SO ./resources/textures/brick.xpm
WE ./resources/textures/grey.xpm
EA ./resources/textures/door.xpm
S ./resources/textures/barrel.xpm   

R -500 500


C 122, 2 , 222

   


F 253 , 10 , 112

11
121   
 1111111         11
101010101       101
11111111       111111
100000001
 1001111                111111 11   1111
 1001                  10000001    1011
  11                   10011111    111
                       111
 11   1      1       11                
 1211121111110111111111111111
11220000001000000000000100001111111
12221101100000121101110020000100001              111111111
10110111111111011100000100000111111   111111111110000000001
11110111111111011101010010001         100200000000000000001
10000001100010000000000100021         100200000000000000001
1E020000000000001100000010001         11111000000000111111
120000002000011010100100001111            12000000001
1000000110010100101101111000011           11111111111
1001011  1110101 101111010001
1111111   11111   1111111111