R 1920 1080
NO ./resources/textures/blue.xpm
SO ./resources/textures/brick.xpm
WE ./resources/textures/grey.xpm
EA ./resources/textures/door.xpm
S ./resources/textures/barrel.xpm
F 255,255,255
C 255,12,255

111111111111111
100000000111001
1000000001 1001111111111111111111
100002000111000000000000000000001
100000000000020000000000000000001
100E00000000000002000000000000001
111111111111100000111111111111111
            10000001
1111        10000001
100111111111100000011111111111
100000000000000000000000000001
111111111111111111111111111111
