R 400 400
NO ./resources/textures/blue.xpm
SO ./resources/textures/brick.xpm
WE ./resources/textures/grey.xpm
EA ./resources/textures/door.xpm
S ./resources/textures/barrel.xpm
F 255,255,255
C 255,12,255
                
111111111111111111111111
1W0000000000000000000001
100000000000000000000001
100000000000000000000001
100000000000000000000001
100000000000000000000001
100000000000000000000001
100000000000000000000001
111111111111111111111111