

NO ./resources/textures/pared1.xpm

SO ./resources/textures/pared2.xpm

WE ./resources/textures/pared3.xpm



EA ./resources/textures/pared4.xpm



S ./resources/textures/barrol.xpm

R       500         523


F 123    , 45    , 67    
C 111 , 101 ,       189

 11111111111111111111111
 10000020000000000020001
 10000000000000000000001         11111111111111111111
 10200000000200000000001         10000000000000000001
 11111111111111111110111         10111111111111111101
                   101           101              101
                 11101111111111111011111          101
                 10000000000200000000001   1111111101111111111
                 12000000000000000000001   1000200000020000001
                 10000000000000000020001   1000000000000000001
                 11111111111111111111111   1200000000000000021
                                           1000000000000000001
                                       11111000000000200000001
                                       10000000000000000000021
     11111111111                       10111000200000000000001
     10000000001                       101 1111111111111110111
     11000000011                       101               101
      110000011                     111101111            101
       1100011                      100000021            101
        11011                       102000001            101
         111                        1000W5001            101
                                    102002001            101
                                    111111111            101
                                                         101
                                                         101
                                                         101
                                                         101
                                                         101      1      1111    1
                                                         101      1     110011   1
                                                         101      1    11000011  1
                                                         101      1     110011   1
                                                         101      1111   1111    1111
                                                         101
                                                         101
                                                         101
                                                         101
                                                         101
                                                         101
                                                         101
                                                         101
                                                         101
                                                         101
111111111111111111111111111111111111111111111111111111111101
100000005000000000000000000000000000000000000000000000000001
102002002002002020020020020020200200200200202002002002000111
1000000000000000000000000000000000000000000000000000000001
1020020020020020200200200200202002002002002020020020020001
1000000000000000000000000000000000000000000000000000000001
1020020020020020200200200200202002002002002020020020020001
1000000000000000000000000000000000000000000000000000000001
1020020020020020200200200200202002002002002020020020020001
1000000000000000000000000000000000000000000000000000000001
1020020020020020200200200200202002002002002020020020020001
1000000000000000000000000000000000000000000000000000000001
1020020020020020200200200200202002002002002020020020020001
1000000000000000000000000000000000000000000000000000000001
1020020020020020200200200200202002002002002020020020020001
1000000000000000000000000000000000000000000000000000000001
1020020020020020200200200200202002002002002020020020020001
1000000000000000000000000000000000000000000000000000000001
1020020020020020200200200200202002002002002020020020020001
1000000000000000000000000000000000000000000000000000000001
1020020020020020200200200200202002002002002020020020020001
1000000000000000000000000000000000000000000000000000000001
1111111111111111111111111111111111111111111111111111111111